18,8,8,1,8,13,8,13,0,8
6,2,2,1,8,8,0,8,8,1
2,2,14,14,8,8,8,8,8,14
14,14,14,14,14,14,20,20,14,14
14,14,14,14,14,14,20,20,14,14
14,14,14,14,14,14,20,20,14,14
18,14,14,14,14,14,20,20,14,14
18,18,18,18,14,14,20,20,14,14
6,6,6,6,18,18,18,18,18,18
2,2,2,2,6,6,6,6,6,6
2,2,2,2,2,2,2,2,2,2
